"a" = (/turf/simulated/floor/exoplanet/chlorine_sand,/area/space)
"b" = (/turf/simulated/ocean/non_flooded,/area/space)
"c" = (/obj/step_trigger/stopper,/turf/simulated/floor/exoplanet/chlorine_sand,/area/space)
"d" = (/obj/saruti/ark,/turf/simulated/floor/exoplanet/chlorine_sand,/area/space)
"e" = (/turf/simulated/ocean/abyss,/area/space)
"f" = (/obj/smoke_wall/no_time/ammonia,/obj/saruti/ark,/turf/simulated/floor/exoplanet/chlorine_sand,/area/space)
"g" = (/obj/saruti/ark/bluespace,/obj/saruti/ark/bluespace,/turf/simulated/floor/exoplanet/chlorine_sand,/area/space)
"i" = (/obj/step_trigger/mobius_rift/seamless_portal,/turf/simulated/floor/exoplanet/chlorine_sand,/area/space)
"j" = (/obj/machinery/door/window{dir = 8},/turf/simulated/floor/exoplanet/chlorine_sand,/area/space)
"k" = (/obj/step_trigger/mobius_rift/seamless_portal,/obj/step_trigger/mobius_rift/seamless_portal,/obj/step_trigger/mobius_rift/seamless_portal,/obj/step_trigger/mobius_rift/seamless_portal,/turf/simulated/floor/exoplanet/chlorine_sand,/area/space)
"m" = (/obj/machinery/door/blast/bordergate/right,/turf/simulated/floor/exoplanet/chlorine_sand,/area/space)
"n" = (/turf/unsimulated/wall/away/blueriver/livingwall{desc = "You feel a sense of dread from just looking at this wall. Its surface seems to be constantly moving, as if it were breathing."},/area/space)
"o" = (/obj/saruti/ark/bluespace,/obj/step_trigger/mobius_rift/seamless_portal,/turf/simulated/floor/exoplanet/chlorine_sand,/area/space)
"r" = (/turf/simulated/floor/beach/sand/saruti,/area/space)
"s" = (/obj/smoke_wall/no_time/ammonia{density = 1; opacity = 1},/turf/simulated/floor/exoplanet/chlorine_sand,/area/space)
"t" = (/obj/machinery/door/blast/bordergate/central,/turf/simulated/floor/exoplanet/chlorine_sand,/area/space)
"u" = (/obj/step_trigger/mobius_rift/seamless_portal,/obj/step_trigger/mobius_rift/seamless_portal,/turf/simulated/floor/exoplanet/chlorine_sand,/area/space)
"v" = (/obj/smoke_wall/no_time/ammonia{density = 1; opacity = 1},/obj/smoke_wall/no_time/ammonia{density = 1; opacity = 1},/turf/simulated/floor/exoplanet/chlorine_sand,/area/space)
"y" = (/obj/smoke_wall/no_time/ammonia,/turf/simulated/floor/exoplanet/chlorine_sand,/area/space)
"A" = (/obj/structure/fd/bluespace_drive,/turf/simulated/floor/exoplanet/chlorine_sand,/area/space)
"C" = (/obj/saruti/ark/bluespace,/turf/simulated/floor/exoplanet/chlorine_sand,/area/space)
"D" = (/obj/structure/table/woodentable/walnut,/obj/structure/window/reinforced{dir = 8},/turf/simulated/floor/exoplanet/chlorine_sand,/area/space)
"E" = (/obj/structure/table/mag,/turf/simulated/floor/exoplanet/chlorine_sand,/area/space)
"F" = (/turf/unsimulated/wall,/area/space)
"H" = (/obj/saruti/ark,/obj/smoke_wall/no_time/ammonia,/turf/simulated/floor/exoplanet/chlorine_sand,/area/space)
"J" = (/obj/structure/bed/chair/office/blue{dir = 1},/turf/simulated/floor/exoplanet/chlorine_sand,/area/space)
"L" = (/obj/smoke_wall/no_time/ammonia{density = 1; opacity = 1},/obj/saruti/ark,/turf/simulated/floor/exoplanet/chlorine_sand,/area/space)
"M" = (/obj/step_trigger/mobius_rift/seamless_portal,/obj/step_trigger/mobius_rift/seamless_portal,/obj/step_trigger/mobius_rift/seamless_portal,/obj/step_trigger/mobius_rift/seamless_portal,/obj/step_trigger/mobius_rift/seamless_portal,/turf/simulated/floor/exoplanet/chlorine_sand,/area/space)
"R" = (/obj/machinery/door/blast/bordergate,/turf/simulated/floor/exoplanet/chlorine_sand,/area/space)
"S" = (/obj/structure/table/woodentable/walnut,/turf/simulated/floor/exoplanet/chlorine_sand,/area/space)
"T" = (/turf/unsimulated/wall/away/blueriver/livingwall{desc = "You feel a sense of dread from just looking at this wall. Its surface seems to be constantly moving, as if it were breathing."; infra_luminosity = 1},/area/space)
"U" = (/obj/step_trigger/mobius_rift/seamless_portal,/obj/step_trigger/mobius_rift/seamless_portal,/obj/step_trigger/mobius_rift/seamless_portal,/turf/simulated/floor/exoplanet/chlorine_sand,/area/space)
"X" = (/turf/space,/area/space)
"Y" = (/turf/simulated/floor/beach/sand,/area/space)
"Z" = (/obj/portal,/turf/simulated/floor/exoplanet/chlorine_sand,/area/space)

(1,1,1) = {"
FFFFFFFFFFFFFFFFFFFFFFFFFFFFFFFFFFFFFFFFFFFFFFFFFFFFFFFFFFFFFFFFFFFFFFFFFFFFFFFFFFFFFFFFFFFFFFFFFYar
FsssssssssssssssssssssLLLLvvssssssssssssssssssssssssssssssssssssssssssssssssssssssssssssssssssssFnbe
FsyyyyyyyyyyyyyyyyyyyyffffyyyyyyyyyyyyyyyyyyyyyyyyyyyyyyyyyyyyyyyyyyyyyyyyyyyyyyyyyyyyyyyyyyyyyyFFFF
FsyyyyyyyyyyyyyyyyyyyyffffyyyyyyyyyyyyyyyyyyyyyyyyyyyyyyyyyyyyyyyyyyyyyyyyyyyyyyyyyyyyyyyyyyyyysaaaF
FsyyyyyaaaaaayyyyyyyyyHHddaaaaaaaaaaaaaaaaaaaaaaaaaaaaaaaaaaaaaaaaaaaaaaaaaaaaaaaaaaaaaaaaaaayysaaaF
FsyyyyaaaaaaaaayyyyyyyddddaaaaaaaaaaaaaaaaaaaaaaaaaaaaaaaaaaaaaaaaaaaaaaaaaaaaaaaaaaaaaaaaaaayysaaaF
FsyyyaaaaaaaaaaaaaayyaddddaaaaaaaaaaaaaaaaaaaaaaaaaaaaaaaaaaaaaaaaaaaaaaaaaaaaaaaaaaaaaaaaaaayysaaaF
FsyyaaaaaaaaaaaaaaaaaCddddaaaaaaaaaaaaaaaaaaaaaaaaaaaaaaaaaaaaaaaaaaaaaaaaaaaaaaaaaaaaaaaaaaayysaaaF
FsyyayyaaaaaaaaaaaaaaCddddaaaaaaaaaaaaaaaaaaaaaaaaaaaaaaaaaaaaaaaaaaaaaaaaaaaaaaaaaaaaaaaaaaayysaaaF
FsyyyyyaaaaaaaaaaaaCCCddddaaaaaaaaaaaaaaaaaaaaaaaaaaaaaaaaaaaaaaaaaaaaaaaaaaaaaaaaaaaaaaaaaaayysaaaF
FsyyyyaaaaaZaaaaaaaaCCddddaaaaaaaaaaaaaaaaaaaaaaaaaaaaaaaaaaaaaaaaaaaaaaaaaaaaaaaaaaaaaaaaaaayysaaaF
FsyyyaaaaaaaaaaaaaaaaCddddaaaaaaaaaaaaaaaaaaaaaaaaaaaaaaaaaaaUuuuuMiiiiiiiiiiiiiiiiiiuaaaaaaayysaaaF
FsyyyyaaaaaaaaaaaaaaaaddddaaaaaaaaaaaaaaaaaaaaaaaaaaaaaaaaaaaiaaaaaaaaaaaaaaaaaaaaaaaiaaaaaaayysaaaF
FsyyaaaaaaaaaaaaaaaaaaddddaaaaaaaaaaaaaaaaaaaaaaaaaaaaaaaaaaaiaaaaaaaaaaaaaaaaaaaaaaaiaaaaaaayysaaaF
FsyyaaaaaaaaaaaaaaaaaaddddaaaaaaaaaaaaaaaaaaaaaaaaaaaaaaaaaaaiaaaaaaaaaaaaaaaaaaaaaaaiaaaaaaayysaaaF
FsyyyaaaaaaaaaaaaaaaaannnnaCaaaaaaaaaaaaaaaaaaaaaaaaaaaaaaaaaiaaaaaaaaaaaaaaaaaaaaaaaiaaaaaaayysaaaF
FsyyyyaaaaaaaaaaaaaaaannnnCCaaaaaaaaaaaaaaaaaaaaaaaaaaaaaaaaaiaaaaaaaaaaaaaaaaaaaaaaaiaaaaaaayysaaaF
FsyyyyyaaaaaaaaaaaaaaCnnnnCCaaaaaaaaaaaaaaaaaaaaaaaaaaaaaaaaaiaaaaaaaaaaaaaaaaaaaaaaaiaaaaaaayysaaaF
FsyyyyaaaaaaaaaaaaaaaCnnnngCaaaaaaaaaaaaaaaaaaaaaaaaaaaaaaaaaiaaaaaaaaaaaaaaaaaaaaaaaiaaaaaaayysaaaF
FsyyyyaaaaaaaaaaaaaaaCgCCaCaaaaaaaaaaaaaaaaaaaaaaaaaaaaaaaaaaiaaaaaaaaaaaaaaaaaaaaaaaiaaaaaaayysaaaF
FsyyyyaaaaaaaaaaaaaaaaCCaaaaaaaaaaaaaaaaaaaaaaaaaaaaaaaaaaaaaiaaaaaaaaaaaaaaaaaaaaaaaiaaaaaaayysaaaF
FsyyayaaaaaaaaaaaaaaaaaaaaaaaaaaaaaaaaaaaaaaaaaaaaaaaaaaaaaaaiaaaaaaaaaaaaaaaaaaaaaaaiaaaaaaayysaaaF
FsyyaaaaaaaaaaaaaaaaaaaaaaaaaaaaaaaaaaaaaaaaaaaaaaaaaaaaaaaaaiaaaaaaaaaaaaaaaaaaaaaaaiaaaaaaayysaaaF
FsyyaaaaaaaaaaaaaaaaaaaaaaaaaaaaaaaaaaaaaaaaaaaaaaaaaaaaaaaaaiaaaaaaaaaaaaaaaaaaaaaaaiaaaaaaayysaaaF
FsyyaaaaaaaaaaaaaaaaaaaaaaaaaaaaaaaaaaaaaaaaaaaaaaaaaaaaaaaaaiaaaaaaaaaaaaaaaaaaaaaaaiaaaaaaayysaaaF
FsyyaaaaaaaaaaaaaaaaaaaaaaaaaaaaaaaaaaaaaaaaaaaaaaaaaaaaaaaaaiaaaaaaaaaaaaaaaaaaaaaaaiaaaaaaayysaaaF
FsyyaaaaaaaaaaaaaaaaaaaaaaaaaaaaaaaaaaaaaaaaaaaaaaaaaaaaaaaaaiaaaaaaaaaaaaaaaaaaaaaaaiaaaaaaayysaaaF
FsyyaaaaaaaaaaaaaaaaaaaaaaaaaaaaaaaaaaaaaaaaaaaaaaaaaaaaaaaaaiaaaaaaaaaaaaaaaaaaaaaaaiaaaaaaayysaaaF
FsyyaaaaaaaaaaaaaaaaaaaaaaaaaaaaaaaaaaaaaaaaaaaaaaaaaaaaaaaaaiaaaaaaaaaaaaaaaaaaaaaaaiaaaaaaayysaaaF
FsyyaaaaaaaaaaaaaaaaaaaaaaaaaaaaaaaaaaaaaaaaaaaaaaaaaaaaaaaaaiaaaaaaaaaaaaaaaaaaaaaaaiaaaaaaayysaaaF
FsyyaaaaaaaaaaaaaaaaaaaaaaaaaaaaaaaaaaaaaaaaaaaaaaaaaaaaaaaaaiaaaaaaaaaaaaaaaaaaaaaaaiaaaaaaayysaaaF
FsyyaaaaaaaaaaaaaaaaaaaaaaaaaaaaaaaaaaaaaaaaaaaaaaaaaaaaaaaaaiaaaaaaaaaaaaaaaaaaaaaaaiaaaaaaayysaaaF
FsyyaaaaaaaaaaaaaaaaaaaaaaaaaaaaaaaaaaaaaaaaaaaaaaaaaaaaaaaaaiaaaaaaaaaaaaaaaaaaaaaaaiaaaaaaayysaaaF
FsyyaaaaaaaaaaaaaaaaaaaaaaaaaaaaaaaaaaaaaaaaaaaaaaaaaaaaaaaaaiaaaaaaaaaaaaaaaaaaaaaaaiaaaaaaayysaaaF
FsyyaaaaaaaaaaaaaaaaaaaaaaaaaaaaaaaaaaaaaaaaaaaaaaaaaaaaaaaaaiaaaaaaaaaaaaaaaaaaaaaaaiaaaaaaayysaaaF
FsyyaaaaaaaaaaaaaaaaaaaaaaaaaaaaaaaaaaaaaaaaaaaaaaaaaaaaaaaaauiiiikiiiiiiiiiiiiiiiiiiuaaaaaaayysaaaF
FsyyaaaaaaaaaaaaaaaaaaaaaaaaaaaaaaaaaaaaaaaaaaaaaaaaaaaaaaaaaaaaaaaaaaaaaaaaaaaaaaaaaaaaaaaaayysaaaF
FsyyaaaaaaaaaaaaaaaaaaaaaaaaaaaaaaaaaaaaaaaaaaaaaaaaaaaaaaaaaaaaaaaaaaaaaaaaaaaaaaaaaaaaaaaaayysaaaF
FsyyaaaaaaaaaaaaaaaaaaaaaaaaaaaaaaaaaaaaaaaaaaaaaaaaaaaaaaaaaaaaaaaaaaaaaaaaaaaaaaaaaaaaaaaaayysaaaF
FsyyaaaaaaaaaaaaaaaaaaaaaaaaaaaaaaaaaaaaaaaaaaaaaaaaaaaaaaaaaaaaaaaaaaaaaaaaaaaaaaaaaaaaaaaaayysaaaF
FsyyaaaaaaaaaaaaaaaaaaaaaaaaaaaaaaaaaaaaaaaaaaaaaaaaaaaaaaaaaaaaaaaaaaaaaaaaaaaaaaaaaaaaaaaaayysaaaF
FsyyaaaaaaaaaaaaaaaaaaaaaaaaaaaaaaaaaaaaaaaaaaaaaaaaaaaaaaaaaaaaaaaaaaaaaaaaaaaaaaaaaaaaaaaaayysaaaF
FsyyaaaaaaaaaaaaaaaaaaaaaaaaaaaaaaaaaaaaaaaaaaaaaaaaaaaaaaaaaaaaaaaaaaaaaaaaaaaaaaaaaaaaaaaaayysaaaF
FsyyaaaaaaaaaaaaaaaaaaaaaaannnnnnnnnnnnnnnnnnnnnnnnaaaaaaaaaaaaaaaaaaaaaaaaaaaaaaaaaaaaaaaaaayysaaaF
FsyyaaaaaaaaaaaaaaaaaaaaaaanaaaaaaaaaaaaaaaaaaaaaanaaaaaaaaaaaaaaaaaaaaaaaaaaaaaaaaaaaaaaaaaayysaaaF
FsyyaaaaaaaaaaaaaaaaaaaaaaanaaaaaaaaaaaaaaaaaaaaaanaaaaaaaaaaaaaaaaaaaaaaaaaaaaaaaaaaaaaaaaaayysaaaF
FsyyaaaaaaaaaaaaaaaaaaaaaaanaaaaaaaaaaaaaaaaaaaaaanaaaaaaaaaaaaaaaaaaaaaaaaaaaaaaaaaaaaaaaaaayysaaaF
FsyyaaaaaaaaaaaaaaaaaaaaaaanaaaaaaaaaaaaaaaaaaaaaanaaaaaaaaaaaaaaaaaaaaaaaaaaaaaaaaaaaaaaaaaayysaaaF
FsyyaaaaaaaaaaaaaaaaaaaaaaanaaaaaaaaaaaaaaaaaaaaaanaaaaaaaaaaaaaaaaaaaaaaaaaaaaaaaaaaaaaaaaaayysaaaF
FsyyaaaaaaaaaaaaaaanaaaaaaanaaaaaannnnnnnnnnaaaaaanaaaaaaaaaanaaaaaaaaaaaaaaaaaaaaaaaaaaaaaaayysaaaF
FsyyaaaaaaaaaaaaaaaannaaaannaaaaaanaaaaaaaanaaaaaanaaaaaaaaaanaaaaaaaaaaaaaaaaaaaaaaaaaaaaaaayysaaaF
FsyyaaaaaannnnnnnnnnnnnaaannaaaaaanaaaaaaaanaaaaaannnnnnnnnnnnnaaaaaaaaaaaaaaaaaaaaaaaaaaaaaayysaaaF
FsyyaaaaaaaaaaaaaaaannaaaaanaaaaaanaannnaaanaaaanannaaaaaaaaanaaaaaaaaaaaaaaaaaaaaaaaaaaaaaaayysaaaF
FsyyaaaaaaaaaaaaaaanaaaaaaanaaaaaanaanXnaaanaaannnnaaaaaaaaaaaaaaaaaaaaaaaaaaaaaaaaaaaaaaaaaayysaaaF
FsyyaaaaaaaaaaaaaaaaaaaaaaanaaaaaanaannnaaanaaaananaaaaaaaaaaaaaaaaaaaaaaaaaaaaaaaaaaaaaaaaaayysaaaF
FsyyaaaaaaaaaaaaaaaaaaaaaaanaaaaaanaaaaaaaanaaaaaanaaaaaaaaaaaaaaaaaaaaaaaaaaaaaaaaaaaaaaaaaayysaaaF
FsyyaaaaaaaaaaaaaaaaaaaaaaanaaaaaanaaaaaaaanaaaaaanaaaaaaaaaaaaaaaaaaaaaaaaaaaaaaaaaaaaaaaaaayysaaaF
FsyyaaaaaaaaaaaaaaaaaaaaaaanaaaaaanaaaaaaaanaaaaaanaaaaaaaaaaaaaaaaaaaaaaaaaaaaaaaaaaaaaaaaaayysaaaF
FsyyaaaaaaaaaaaaaaaaaaaaaaanaaaaaannnnnnnnnnaaaaaanaaaaaaaaaaaaaaaaaaaaaaaaaaaaaaaaaaaaaaaaaayysaaaF
FsyyaaaaaaaaaaaaaaaaaaaaaaanaaaaaaaaaaaaaaaaaaaaaanaaaaaaaaaaaaaaaaaaaaaaaaaaaaaaaaaaaaaaaaaayysaaaF
FsyyaaaaaaaaaaaaaaaaaaaaaaanaaaaaaaaaaaaaaaaaaaaaanaaaaaaaaaaaaaaaaaaaaaaaaaaaaaaaaaaaaaaaaaayysaaaF
FsyyaaaaaaaaaaaaaaaaaaaaaaanaaaaaaaaaaaaaaaaaaaaaanaaaaaaaaaaaaaaaaaaaaaaaaaaaaaaaaaaaaaaaaaayysaaaF
FsyyaaaaaaaaaaaaaaaaaaaaaaanaaaaaaaaaaaaaaaaaaaaaanaaaaaaaaaaaaaaaaaaaaaaaaaaaaaaaaaaaaaaaaaayysaaaF
FsyyaaaaaaaaaaaaaaaaaaaaaaanaaaaaaaaaaaaaaaaaaaaaanaaaaaaaaaaaaaaaaaaaaaaaaaaaaaaaaaaaaaaaaaayysaaaF
FsyyaaaaaaaaaaaaaaaaaaaaaaannnnnnnnnnnXnnnnnnnnnnnnaaaaaaaaaaaaaaaaaaaaaaaaaaaaaaaaaaaaaaaaaayysaaaF
FsyyaaaaaaaaaaaaaaaaaaaaaaaaaaaaaaaaaaaaaaaaaaaaaaaaaaaaaaaaaaaaaaaaaaaaaaaaaaaaaaaaaaaaaaaaayysaaaF
FsyyaaaaaaaaaaaaaaaaaaaaaaaaaaaaaaaaaaaaaaaaaaaaaaaaaaaaaaaaaaaaaaaaaaaaaaaaaaaaaaaaaaaaaaaaayysaaaF
FsyyaaaaaaaaaaaaaaaaaaaaaaaaaaaaaaaaaaaaaaaaaaaaaaaaaaaaaaaaaaaaaaaaaaaaaaaaaaaaaaaaaaaaaaaaayysaaaF
FsyyaaaaaaaaaaaaaaaaaaaaaaaaaaaaaaaaaaaaaaaaaaaaaaaaaaaaaaaaaaaaaaaaaaaaaaaaaaaaaaaaaaaaaaaaayysaaaF
FsyyaaaaaaaaaaaaaaaaaaaaaaaaaaaaaaaaaaaaaaaaaaaaaaaaaaaaaaaaaaaaaaaaaaaaaaaaaaaaaaaaaaaaaaaaayysaaaF
FsyyaaaaaaaaaaaaaaaaaaaaaaaaaaaaaaaaaaaaaaaaaaaaaaaaaaaaaaaaaaaaaaaaaaaaaaaaaaaaaaaaaaaaaaaaayysaaaF
FsyyaaaaaaaaaaaaaaaaaaaaaaaaaaaaaaaaaaaaaaaaaaaaaaaaaaaaaaaaaaaaaaaaaaaaaaaaaaaaaaaaaaaaaaaaayysaaaF
FsyyaaaaaaaaaaaaaaaaaaaaaaaaaaaaaaaaaaaaaaaaaaaaaaaaaaaaaaaaaaaaaaaaaaaaaaaaaaaaaaaaaaaaaaaaayysaaaF
FsyyaaaaaaaaaaaaaaaaaaaaaaaaaaaaaaaaaaaaaaaaaaaaaaaaaaaaaaaaaaaaaaaaaaaaaaaaaaaaaaaaaaaaaaaaayysaaaF
FsyyaaaaaaaaaaaaaaaaaaaaaaaaaaaaaaaaaanRtttmnaaaaaaaaaaaaaaaaaaaaaaaaaaaaaaaaaaaaaaaaaaaaaaaayysaaaF
FsyyaaaaaaaaaaaaaaaaaaaaaaaaaaaaaaaaaanaaaaanaaaaaaaaaaaaaaaaaaaaaaaaaaaaaaaaaaaaaaaaaaaaaaaayysaaaF
FsyyaaaaaaaaaaaaaaaaaaaaaaaaaaaaaaaaaanaaaaanaaaaaaaaaaaaaaaaaaaaaaaaaaaaaaaaaaaaaaaaaaaaaaaayysaaaF
FsyyaaaaaaaaaaaaaaaaaaaaaaaaaaaaaaaaaanaaaaanaaaaaaaaaaaaaaaaaaaaaaaaaaaaaaaaaaaaaaaaaaaaaaaayysaaaF
FsyyaaaaaaaaaaaaaaaaaaaaaaaaaaaaaaaaaanaaaaanaaaaaaaaaaaaaaaaaaaaaaaaaaaaaaaaaaaaaaaaaaaaaaaayysaaaF
FsyyaaaaaaaaaaaaaaaaaaaaaaaaaannnnnnnnnRtttmnnnnnnnnnaaaaaaaaaaaaaaaaaaaaaaaaaaaaaaaaaaaaaaaayysaaaF
FsyyaaaaaaaaaaaaaaaaaaaaaaaaaaaaaaaaaaaaaaaaaaaaaaaaaaaaaaaaaaaaaaaaaaaaaaaaaaaaaaaaaaaaaaaaayysaaaF
FsyyaaaaaaaaaaaaaaaaaaaaaaaaaaaaaaaaaaaaaaaaaaaaaaaaaaaaaaaaaaaaaaaaaaaaaaaaaaaaaaaaaaaaaaaaayysaaaF
FsyyaaaaaaaaaaaaaaaaaaaaaaaaaaaaaaaaaaaaaaaaaaaaaaaaaaaaaaaaaaaaaaaaaaaaaaaaaaaaaaaaaaaaaaaaayysaaaF
FsyyaaaaaaaaaaaaaaaaaaaaaaaaaaaaaaaaaaaaaaaaaaaaaaaaaaaaaaaaaaaaaaaaaaaaaaaaaaaaaaaaaaaaaaaaayysaaaF
FsyyaaaaaaaaaaaaaaaaaaaaaaaaaaaaaaaaaaaaaaaaaaaaaaaaaaaaaaaaaaaaaaaaaaaaaaaaaaaaaaaaaaaaaaaaayysaaaF
FsyyaaaaaaaaaaaaaaaaaaaaaaaaaaaaaaaaaaaaaaaaaaaaaaaaaaaaaaaaaaaaaaaaaaaaaaaaaaaaaaaaaaaaaaaaayysaaaF
FsyyaaaaaaaaaaaaaaaaaaaaaaaaaaaaaaaaaaaaaaaaaaaaaaaaaaaaaaaaaaaaaaaaaaaaaaaaaaaaaaaaaaaaaaaaayysaaaF
FsyyaaaaaaaaaaaaaaaaaaaaaaaaaaaaaaaaaaaaaaaaaaaaaaaaaaaaaaaaaaaaaaaaaaaaaaaaaaaaaaaaaaaaaaaaayysaaaF
FsyyaaaaaaaaaaaaaaaaaaaaaaaaaaaaaaaaaaaaaaaaaaaaaaaaaaaaaaaaaaaaaaaaaaaaaaaaaaaaaaaaaaaaaaaaayysaaaF
FsyyaaaaaaaaaaaaaaaaaaaaaaaaaaaaaaaaaaaaaaaaaaaaaaaaaaaaaaaaaaaaaaaaaaaaaaaaaaaaaaaaaaaaaaaaayysaaaF
FsyyaaaaaaaaaaaaaaaaaaaaaaaaaaaaaaaaaaaaaaaaaaaaaaaaaaaaaaaaaaaaaaaaaaaaaaaaaaaaaaaaaaaaaaaaayysaaaF
FsyyaaaaaaaaaaaaaaaaaaaaaaaaaaaaaaaaaaaaaaaaaaaaaaaaaaaaaaaaaaaaaaaaaaaaaaaaaaaaaaaaaaaaaaaaayysaaaF
FsyyaaaaaaaaaaaaaaaaaaaaaaaaaaaaaaaaaaaaaaaaaaaaaaaaaaaaaaaaaaaaaaaaaaaaaaaaaaaaaaaaaaaaaaaaayysaaaF
FsyyaaaaaaaaaaaaaaaaaaaaaaaaaaaaaaaaaaaaaaaaaaaaaaaaaaaaaaaaaaaaaaaaaaaaaaaaaaaaaaaaaaaaaaaaayysaaaF
FsyyaaaaaaaaaaaaaaaaaaaaaaaaaaaaaaaaaaaaaaaaaaaaaaaaaaaaaaaaaaaaaaaaaaaaaaaaaaaaaaaaaaaaaaaaayysaaaF
FsyyaaaaaaaaaaaaaaaaaaaaaaaaaaaaaaaaaaaaaaaaaaaaaaaaaaaaaaaaaaaaaaaaaaaaaaaaaaaaaaaaaaaaaaaaayysaaaF
FsyyyyyyyyyyyyyyyyyyyyyyyyyyyyyyyyyyyyyyyyyyyyyyyyyyyyyyyyyyyyyyyyyyyyyyyyyyyyyyyyyyyyyyyyyyyyysaaaF
FsyyyyyyyyyyyyyyyyyyyyyyyyyyyyyyyyyyyyyyyyyyyyyyyyyyyyyyyyyyyyyyyyyyyyyyyyyyyyyyyyyyyyyyyyyyyyysaaaF
FssssssssssssssssssssssssssssssssssssssssssssssssssssssssssssssssssssssssssssssssssssssssssssyysaaaF
FFFFFFFFFFFFFFFFFFFFFFFFFFFFFFFFFFFFFFFFFFFFFFFFFFFFFFFFFFFFFFFFFFFFFFFFFFFFFFFFFFFFFFFFFFFFFFFFFFFF
"}
(1,1,2) = {"
FFFFFFFFFFFFFFFFFFFFFFFFFFFFFFFFFFFFFFFFFFFFFFFFFFFFFFFFFFFFFFFFFFFFFFFFFFFFFFFFFFFFFFFFFFFFFFFFFFFF
FaaaaaaaaaaaaaaaaaaaaaaaaaaaaaaaaaaaaaaaaaaaaaaaaaaaaaaaaaaaaaaaaaaaaaaaaaaaaaaaaaaaaaaaaaaaaaaaaaaF
FaaaaaaaaaaaaaaaaaaaaaaaaaaaaaaaaaaaaaaaaaaaaaaaaaaaaaaaaaaaaaaaaaaaaaaaaaaaaaaaaaaaaaaaaaaaaaaaaaaF
FaaaaaaaaaaaaaaaaaaaaaaaaaaaaaaaaaaaaaaaaaaaaaaaaaaaaaaaaaaaaaaaaaaaaaaaaaaaaaaaaaaaaaaaaaaaaaaaaaaF
FaaaaaaaaaaaaaaaaaaaaaaaaaaaaaaaaaaaaaaaaaaaaaaaaaaaaaaaaaaaaaaaaaaaaaaaaaaaaaaaaaaaaaaaaaaaaaaaaaaF
FaaaaaaaaaaaaaaaaaaaaaaaaaaaaaaaaaaaaaaaaaaaaaaaaaaaaaaaaaaaaaaaaaaaaaaaaaaaaaaaaaaaaaaaaaaaaaaaaaaF
FaaaaaaaaaaaaaaaaaaaaaaaaaaaaaaaaaaaaaaaaaaaaaaaaaaaaaaaaaaaaaaaaaaaaaaaaaaaaaaaaaaaaaaaaaaaaaaaaaaF
FaaaaaaanaaaaaaaaaaaaaaaaaaaaaaaaaaaaaaaaaaaaaaaaaaaaaaaaaaaaaaaaaaaaaaaaaaaaaaaaaaaaaaaaaaaaaaaaaaF
FaaaaaaaanaaaaaaaaaaaaaaaaaaaaaaaaaaaaaaaaaaaaaaaaaaaaaaaaaaaaaaaaaaaaaaaaaaaaaaaaaaaaaaaaaaaaaaaaaF
FaaaaaaaaaaaaaaaaaaaaaaaaaaaaaaaaaaaaaaaaaaaaaaaaaaaaaaaaaaaaaaaaaaaaaaaaaaaaaaaaaaaaaaaaaaaaaaaaaaF
FaaaaaaaaaaaaaaaaaaaaaaaaaaaaaaaaaaaaaaaaaaaaaaaaaaaaaaaaaaaaaaaaaaaaaaaaaaaaaaaaaaaaaaaaaaaaaaaaaaF
FaaaaaaaaaaaaaaaaaaaaaaaaaaaaaaaaaaaaaaaaaaaaaaaaaaaaaaaaaaaaaaaaaaaaaaaaaaaaaaaaaaaaaaaaaaaaaaaaaaF
FaaaaaaaaaaaaaaaaaaaaaaaaaaaaaaaaaaaaaaaaaaaaaaaaaaaaaaaaaaaaaaaaaaaaaaaaaaaaaaaaaaaaaaaaaaaaaaaaaaF
FaaaaaaaaaaaaaaaaaaaaaaaaaaaaaaaaaaaaaaaaaaaaaaaaaaaaaaaaaaaaaaaaaaaaaaaaaaaaaaaaaaaaaaaaaaaaaaaaaaF
FaaaaaaaaaaaaaaaaaaaaaaaaaaaaaaaaaaaaaaaaaaaaaaaaaaaaaaaaaaaaaaaaaaaaaaaaaaaaaaaaaaaaaaaaaaaaaaaaaaF
FaaaaaaaaaaaaaaaaaaaaaaaaaaaaaaaaaaaaaaaaaaaaaaaaaaaaaaaaaaaaaaaaaaaaaaaaaaaaaaaaaaaaaaaaaaaaaaaaaaF
FaaaaaaaaaaaaaaaaaaaaaaaaaaaaaaaaaaaaaaaaaaaaaaaaaaaaaaaaaaaaaaaaaaaaaaaaaaaaaaaaaaaaaaaaaaaaaaaaaaF
FaaaaaaaaaaaaaaaaaaaaaaaaaaaaaaaaaaaaaaaaaaaaaaaaaaaaaaaaaaaaaaaaaaaaaaaaaaaaaaaaaaaaaaaaaaaaaaaaaaF
FaaaaaaaaaaaaaaaaaaaaaaaaaaaaaaaaaaaaaaaaaaaaaaaaaaaaaaaaaaaaaaaaaaaaaaaaaaaaaaaaaaaaaaaaaaaaaaaaaaF
FaaaaaaaaaaaaaaaaaaaaaaaaaaaaaaaaaaaaaaaaaaaaaaaaaaaaaaaaaaaaaaaaaaaaaaaaaaaaaaaaaaaaaaaaaaaaaaaaaaF
FaaaaaaaaaaaaaaaaaaaaaaaaaaaaaaaaaaaaaaaaaaaaaaaaaaaaaaaaaaaaaaaaaaaaaaaaaaaaaaaaaaaaaaaaaaaaaaaaaaF
FaaaaaaaaaaaaaaaaaaaaaaaaaaaaaaaaaaaaaaaaaaaaaaaaaaaaaaaaaaaaaaaaaaaaaaaaaaaaaaaaaaaaaaaaaaaaaaaaaaF
FaaaaaaaaaaaaaaaaaaaaaaaaaaaaaaaaaaaaaaaaaaaaaaaaaaaaaaaaaaaaaaaaaaaaaaaaaaaaaaaaaaaaaaaaaaaaaaaaaaF
FaaaaaaaaaaaaaaaaaaaaaaaaaaaaaaaaaaaaaaaaaaaaaaaaaaaaaaaaaaaaaaaaaaaaaaaaaaaaaaaaaaaaaaaaaaaaaaaaaaF
FaaaaaaaaaaaaaaaaaaaaaaaaaaaaaaaaaaaaaaaaaaaaaaaaaaaaaaaaaaaaaaaaaaaaaaaaaaaaaaaaaaaaaaaaaaaaaaaaaaF
FaaaaaaaaaaaaaaaaaaaaaaaaaaaaaaaaaaaaaaaaaaaaaaaaaaaaaaaaaaaaaaaaaaaaaaaaaaaaaaaaaaaaaaaaaaaaaaaaaaF
FaaaaaaaaaaaaaaaaaaaaaaaaaaaaaaaaaaaaaaaaaaaaaaaaaaaaaaaaaaaaaaaaaaaaaaaaaaaaaaaaaaaaaaaaaaaaaaaaaaF
FaaaaaaaaaaaaaaaaaaaaaaaaaaaaaaaaaaaaaaaaaaaaaaaaaaaaaaaaaaaaaaaaaaaaaaaaaaaaaaaaaaaaaaaaaaaaaaaaaaF
FaaaaaaaaaaaaaaaaaaaaaaaaaaaaaaaaaaaaaaaaaaaaaaaaaaaaaaaaaaaaaaaaaaaaaaaaaaaaaaaaaaaaaaaaaaaaaaaaaaF
FaaaaaaaaaaaaaaaaaaaaaaaaaaaaaaaaaaaaaaaaaaaaaaaaaaaaaaaaaaaaaaaaaaaaaaaaaaaaaaaaaaaaaaaaaaaaaaaaaaF
FaaaaaaaaaaaaaaaaaaaaaaaaaaaaaaaaaaaaaaaaaaaaaaaaaaaaaaaaaaaaaaaaaaaaaaaaaaaaaaaaaaaaaaaaaaaaaaaaaaF
FaaaaaaaaaaaaaaaaaaaaaaaaaaaaaaaaaaaaaaaaaaaaaaaaaaaaaaaaaaaaaaaaaaaaaaaaaaaaaaaaaaaaaaaaaaaaaaaaaaF
FaaaaaaaaaaaaaaaaaaaaaaaaaannnnnnnnnnnnnnnnnaaaaaaaaaaaaaaaaaaaaaaaaaaaaaaaaaaaaaaaaaaaaaaaaaaaaaaaF
FaaaaaaaaaaaaaaaaaaaaaaaaaanaaaaaaaaaaaaaaanaannnnnnnnnaaaaaaaaaaaaaaaaaaaaaaaaaaaaaaaaaaaaaaaaaaaaF
FaaaaaaaaaaaaaaaaaaaaaaaaaanaaaaaaaaaaaaaaanaanaaaaaaanaaaaaaaaaaaaaaaaaaaaaaaaaaaaaaaaaaaaaaaaaaaaF
FaaaaaaaaaaaaaaaaaaaaaaaaaanaaaaaaaaaaaaaaanaanaaaaaaanaaaaaaaaaaaaaaaaaaaaaaaaaaaaaaaaaaaaaaaaaaaaF
FaaaaaaaaaaaaaaaaaaaaaaaaaanaaaaaaaaaaaaaaanaanaaaAaaanaaaaaaaaaaaaaaaaaaaaaaaaaaaaaaaaaaaaaaaaaaaaF
FaaaaaaaaaaaaaaaaaaaaaaaaaanaaaaaaaaaaaaaaanaanaaaaaaanaaaaaaaaaaaaaaaaaaaaaaaaaaaaaaaaaaaaaaaaaaaaF
FaaaaaaaaaaaaaaaaaaaaaaaaaanaaaaaaaaaaaaaaanaanaaaaaaanaaaaaaaaaaaaaaaaaaaaaaaaaaaaaaaaaaaaaaaaaaaaF
FaaaaaaaaaaaaaaaaaaaaaaaaaanaaaaaaaaaaaaaaanaanaaaaaaanaaaaaaaaaaaaaaaaaaaaaaaaaaaaaaaaaaaaaaaaaaaaF
FaaaaaaaaaaaaaaaaaaaaaaaaaanaaaaaaaaaaaaaaanaanaaaaaaanaaaaaaaaaaaaaaaaaaaaaaaaaaaaaaaaaaaaaaaaaaaaF
FaaaaaaaaaaaaaaaaaaaaaaaaaanaaaaaaaaaaaaaaanaaaaaaaaaaaaaaaaaaaaaaaaaaaaaaaaaaaaaaaaaaaaaaaaaaaaaaaF
FaaaaaaaaaaaaaaaaaaaaaaaaaanaaaaaaaaaaaaaaanaaaaaaaaaaaaaaaaaaaaaaaaaaaaaaaaaaaaaaaaaaaaaaaaaaaaaaaF
FaaaaaaaaaaaaaaaaaaaaaaaaaannnnnnnnnnnnnnnnnaaaaaaaaaaaaaaaaaaaaaaaaaaaaaaaaaaaaaaaaaaaaaaaaaaaaaaaF
FaaaaaaaaaaaaaaaaaaaaaaaaaaaaaaaaaaaaaaaaaaaaaaaaaaaaaaaaaaaaaaaaaaaaaaaaaaaaaaaaaaaaaaaaaaaaaaaaaaF
FaaaaaaaaaaaaaaaaaaaaaaaaaaaaaaaaaaaaaaaaaaaaaaaaaaaaaaaaaaaaaaaaaaaaaaaaaaaaaaaaaaaaaaaaaaaaaaaaaaF
FaaaaaaaaaaaaaaaaaaaaaaaaaaaaaaaaaaaaaaaaaaaaaaaaaaaaaaaaaaaaaaaaaaaaaaaaaaaaaaaaaaaaaaaaaaaaaaaaaaF
FaaaaaaaaaaaaaaaaaaaaaaaaaannnnnnnnnnnnnnnnnnnnnRtttmnnonnnnnnaaaaaaaaaaaaaaaaaaaaaaaaaaaaaaaaaaaaaF
FaaaaaaaaaaaaaaaaaaaaaaaaaanaaaaaaaaaaanSaaaaEEnaaaaanaaanaaanaaaaaaaaaaaaaaaaaaaaaaaaaaaaaaaaaaaaaF
FaaaaaaaaaaaaaaaaaaaaaaaaaanaaaaaaaaaaanSaaaaaanaaaaanaaanaaanaaaaaaaaaaaaaaaaaaaaaaaaaaaaaaaaaaaaaF
FaaaaaaaaaaaaaaaaaaaaaaaaaanaaaaaaaaaaanSaaaDSSnaaaaanaaannnnnnnnnaaaaaaaaaaaaaaaaaaaaaaaaaaaaaaaaaF
FaaaaaaaaaaaaaaaaaaaaaaaaaanaaaaaaaaaaanSaaaDJanaaaaanaaaaaaaiaaacaaaaaaaaaaaaaaaaaaaaaaaaaaaaaaaaaF
FaaaaaaaaaaaaaaaaaaaaaaaaaanaaaaaaaaaaanSaaajaanRtttmnaaaaaaaiaaacaaaaaaaaaaaaaaaaaaaaaaaaaaaaaaaaaF
FaaaaaaaaaaaaaaaaaaaaaaaaaanaaaaaaaaaaannnnnnnnnnnnnnnaaaaaaaiaaacaaaaaaaaaaaaaaaaaaaaaaaaaaaaaaaaaF
FaaaaaaaaaaaaaaaaaaaaaaaaaanaaaaaaaaaaaaaaaaaaaaaaaaannnnnnTnnnnnnaaaaaaaaaaaaaaaaaaaaaaaaaaaaaaaaaF
FaaaaaaaaaaaaaaaaaaaaaaaaaanaaaaaaaaaaaaaaaaaaaaaaaaanaaaaaaaaaaaaaaaaaaaaaaaaaaaaaaaaaaaaaaaaaaaaaF
FaaaaaaaaaaaaaaaaaaaaaaaaaanaaaaaaaaaaaaaaaaaaaaaaaaanaaaaaaaaaaaaaaaaaaaaaaaaaaaaaaaaaaaaaaaaaaaaaF
FaaaaaaaaaaaaaaaaaaaaaaaaaannnnnnnnnnnnnnnnnnnnnnnnnnnaaaaaaaaaaaaaaaaaaaaaaaaaaaaaaaaaaaaaaaaaaaaaF
FaaaaaaaaaaaaaaaaaaaaaaaaaaaaaaaaaaaaaaaaaaaaaaaaaaaaaaaaaaaaaaaaaaaaaaaaaaaaaaaaaaaaaaaaaaaaaaaaaaF
FaaaaaaaaaaaaaaaaaaaaaaaaaaaaaaaaaaaaaaaaaaaaaaaaaaaaaaaaaaaaaaaaaaaaaaaaaaaaaaaaaaaaaaaaaaaaaaaaaaF
FaaaaaaaaaaaaaaaaaaaaaaaaaaaaaaaaaaaaaaaaaaaaaaaaaaaaaaaaaaaaaaaaaaaaaaaaaaaaaaaaaaaaaaaaaaaaaaaaaaF
FaaaaaaaaaaaaaaaaaaaaaaaaaaaaaaaaaaaaaaaaaaaaaaaaaaaaaaaaaaaaaaaaaaaaaaaaaaaaaaaaaaaaaaaaaaaaaaaaaaF
FaaaaaaaaaaaaaaaaaaaaaaaaaaaaaaaaaaaaaaaaaaaaaaaaaaaaaaaaaaaaaaaaaaaaaaaaaaaaaaaaaaaaaaaaaaaaaaaaaaF
FaaaaaaaaaaaaaaaaaaaaaaaaaaaaaaaaaaaaaaaaaaaaaaaaaaaaaaaaaaaaaaaaaaaaaaaaaaaaaaaaaaaaaaaaaaaaaaaaaaF
FaaaaaaaaaaaaaaaaaaaaaaaaaaaaaaaaaaaaaaaaaaaaaaaaaaaaaaaaaaaaaaaaaaaaaaaaaaaaaaaaaaaaaaaaaaaaaaaaaaF
FaaaaaaaaaaaaaaaaaaaaaaaaaaaaaaaaaaaaaaaaaaaaaaaaaaaaaaaaaaaaaaaaaaaaaaaaaaaaaaaaaaaaaaaaaaaaaaaaaaF
FaaaaaaaaaaaaaaaaaaaaaaaaaaaaaaaaaaaaaaaaaaaaaaaaaaaaaaaaaaaaaaaaaaaaaaaaaaaaaaaaaaaaaaaaaaaaaaaaaaF
FaaaaaaaaaaaaaaaaaaaaaaaaaaaaaaaaaaaaaaaaaaaaaaaaaaaaaaaaaaaaaaaaaaaaaaaaaaaaaaaaaaaaaaaaaaaaaaaaaaF
FaaaaaaaaaaaaaaaaaaaaaaaaaaaaaaaaaaaaaaaaaaaaaaaaaaaaaaaaaaaaaaaaaaaaaaaaaaaaaaaaaaaaaaaaaaaaaaaaaaF
FaaaaaaaaaaaaaaaaaaaaaaaaaaaaaaaaaaaaaaaaaaaaaaaaaaaaaaaaaaaaaaaaaaaaaaaaaaaaaaaaaaaaaaaaaaaaaaaaaaF
FaaaaaaaaaaaaaaaaaaaaaaaaaaaaaaaaaaaaaaaaaaaaaaaaaaaaaaaaaaaaaaaaaaaaaaaaaaaaaaaaaaaaaaaaaaaaaaaaaaF
FaaaaaaaaaaaaaaaaaaaaaaaaaaaaaaaaaaaaaaaaaaaaaaaaaaaaaaaaaaaaaaaaaaaaaaaaaaaaaaaaaaaaaaaaaaaaaaaaaaF
FaaaaaaaaaaaaaaaaaaaaaaaaaaaaaaaaaaaaaaaaaaaaaaaaaaaaaaaaaaaaaaaaaaaaaaaaaaaaaaaaaaaaaaaaaaaaaaaaaaF
FaaaaaaaaaaaaaaaaaaaaaaaaaaaaaaaaaaaaaaaaaaaaaaaaaaaaaaaaaaaaaaaaaaaaaaaaaaaaaaaaaaaaaaaaaaaaaaaaaaF
FaaaaaaaaaaaaaaaaaaaaaaaaaaaaaaaaaaaaaaaaaaaaaaaaaaaaaaaaaaaaaaaaaaaaaaaaaaaaaaaaaaaaaaaaaaaaaaaaaaF
FaaaaaaaaaaaaaaaaaaaaaaaaaaaaaaaaaaaaaaaaaaaaaaaaaaaaaaaaaaaaaaaaaaaaaaaaaaaaaaaaaaaaaaaaaaaaaaaaaaF
FaaaaaaaaaaaaaaaaaaaaaaaaaaaaaaaaaaaaaaaaaaaaaaaaaaaaaaaaaaaaaaaaaaaaaaaaaaaaaaaaaaaaaaaaaaaaaaaaaaF
FaaaaaaaaaaaaaaaaaaaaaaaaaaaaaaaaaaaaaaaaaaaaaaaaaaaaaaaaaaaaaaaaaaaaaaaaaaaaaaaaaaaaaaaaaaaaaaaaaaF
FaaaaaaaaaaaaaaaaaaaaaaaaaaaaaaaaaaaaaaaaaaaaaaaaaaaaaaaaaaaaaaaaaaaaaaaaaaaaaaaaaaaaaaaaaaaaaaaaaaF
FaaaaaaaaaaaaaaaaaaaaaaaaaaaaaaaaaaaaaaaaaaaaaaaaaaaaaaaaaaaaaaaaaaaaaaaaaaaaaaaaaaaaaaaaaaaaaaaaaaF
FaaaaaaaaaaaaaaaaaaaaaaaaaaaaaaaaaaaaaaaaaaaaaaaaaaaaaaaaaaaaaaaaaaaaaaaaaaaaaaaaaaaaaaaaaaaaaaaaaaF
FaaaaaaaaaaaaaaaaaaaaaaaaaaaaaaaaaaaaaaaaaaaaaaaaaaaaaaaaaaaaaaaaaaaaaaaaaaaaaaaaaaaaaaaaaaaaaaaaaaF
FaaaaaaaaaaaaaaaaaaaaaaaaaaaaaaaaaaaaaaaaaaaaaaaaaaaaaaaaaaaaaaaaaaaaaaaaaaaaaaaaaaaaaaaaaaaaaaaaaaF
FaaaaaaaaaaaaaaaaaaaaaaaaaaaaaaaaaaaaaaaaaaaaaaaaaaaaaaaaaaaaaaaaaaaaaaaaaaaaaaaaaaaaaaaaaaaaaaaaaaF
FaaaaaaaaaaaaaaaaaaaaaaaaaaaaaaaaaaaaaaaaaaaaaaaaaaaaaaaaaaaaaaaaaaaaaaaaaaaaaaaaaaaaaaaaaaaaaaaaaaF
FaaaaaaaaaaaaaaaaaaaaaaaaaaaaaaaaaaaaaaaaaaaaaaaaaaaaaaaaaaaaaaaaaaaaaaaaaaaaaaaaaaaaaaaaaaaaaaaaaaF
FaaaaaaaaaaaaaaaaaaaaaaaaaaaaaaaaaaaaaaaaaaaaaaaaaaaaaaaaaaaaaaaaaaaaaaaaaaaaaaaaaaaaaaaaaaaaaaaaaaF
FaaaaaaaaaaaaaaaaaaaaaaaaaaaaaaaaaaaaaaaaaaaaaaaaaaaaaaaaaaaaaaaaaaaaaaaaaaaaaaaaaaaaaaaaaaaaaaaaaaF
FaaaaaaaaaaaaaaaaaaaaaaaaaaaaaaaaaaaaaaaaaaaaaaaaaaaaaaaaaaaaaaaaaaaaaaaaaaaaaaaaaaaaaaaaaaaaaaaaaaF
FaaaaaaaaaaaaaaaaaaaaaaaaaaaaaaaaaaaaaaaaaaaaaaaaaaaaaaaaaaaaaaaaaaaaaaaaaaaaaaaaaaaaaaaaaaaaaaaaaaF
FaaaaaaaaaaaaaaaaaaaaaaaaaaaaaaaaaaaaaaaaaaaaaaaaaaaaaaaaaaaaaaaaaaaaaaaaaaaaaaaaaaaaaaaaaaaaaaaaaaF
FaaaaaaaaaaaaaaaaaaaaaaaaaaaaaaaaaaaaaaaaaaaaaaaaaaaaaaaaaaaaaaaaaaaaaaaaaaaaaaaaaaaaaaaaaaaaaaaaaaF
FaaaaaaaaaaaaaaaaaaaaaaaaaaaaaaaaaaaaaaaaaaaaaaaaaaaaaaaaaaaaaaaaaaaaaaaaaaaaaaaaaaaaaaaaaaaaaaaaaaF
FaaaaaaaaaaaaaaaaaaaaaaaaaaaaaaaaaaaaaaaaaaaaaaaaaaaaaaaaaaaaaaaaaaaaaaaaaaaaaaaaaaaaaaaaaaaaanaaaaF
FaaaaaaaaaaaaaaaaaaaaaaaaaaaaaaaaaaaaaaaaaaaaaaaaaaaaaaaaaaaaaaaaaaaaaaaaaaaaaaaaaaaaaaaaaaaaaaaaaaF
FaaaaaaaaaaaaaaaaaaaaaaaaaaaaaaaaaaaaaaaaaaaaaaaaaaaaaaaaaaaaaaaaaaaaaaaaaaaaaaaaaaaaaaaaaaaaaaaaaaF
FaaaaaaaaaaaaaaaaaaaaaaaaaaaaaaaaaaaaaaaaaaaaaaaaaaaaaaaaaaaaaaaaaaaaaaaaaaaaaaaaaaaaaaaaaaaaaaaaaaF
FaaaaaaaaaaaaaaaaaaaaaaaaaaaaaaaaaaaaaaaaaaaaaaaaaaaaaaaaaaaaaaaaaaaaaaaaaaaaaaaaaaaaaaaaaaaaaaaaaaF
FaaaaaaaaaaaaaaaaaaaaaaaaaaaaaaaaaaaaaaaaaaaaaaaaaaaaaaaaaaaaaaaaaaaaaaaaaaaaaaaaaaaaaaaaaaaaaaaaaaF
FFFFFFFFFFFFFFFFFFFFFFFFFFFFFFFFFFFFFFFFFFFFFFFFFFFFFFFFFFFFFFFFFFFFFFFFFFFFFFFFFFFFFFFFFFFFFFFFFFFF
"}
